0 0 1 3 4 4 3 1 3 4 3 3 1 4 4 4 5 1 4 1 3 3 1 3 1 3 1 1 3 3 1 1 1 4 3 3 1 1 1 3 4 1 4 1 3 1 3 0 0 0 
0 0 0 1 4 4 4 5 1 1 3 4 1 4 3 1 3 3 5 4 4 3 4 1 3 3 3 3 1 5 1 3 1 5 3 3 1 1 1 1 1 1 5 1 1 3 5 0 0 0 
0 0 0 0 3 5 4 1 4 1 3 3 1 5 1 5 3 3 3 1 3 3 3 1 4 1 3 1 1 3 3 1 3 3 4 3 1 1 0 1 1 1 3 5 3 1 1 0 0 0 
0 0 0 0 0 1 3 3 4 4 3 4 3 5 1 4 1 4 3 1 5 4 0 3 1 4 3 4 3 6 4 1 1 3 1 3 1 3 1 1 1 1 3 1 3 1 3 0 0 0 
0 0 0 0 0 0 0 4 3 1 1 4 1 1 4 1 1 1 3 3 1 1 4 1 4 4 1 3 3 5 4 5 1 4 4 3 1 1 3 3 0 4 3 4 3 5 3 0 0 0 
0 0 0 0 0 0 0 1 4 1 3 6 6 1 1 3 3 4 3 1 1 3 1 3 1 4 4 3 1 3 3 0 3 1 3 3 4 1 3 1 3 4 4 3 1 4 1 0 0 0 
0 0 0 0 0 0 0 0 3 1 3 1 3 4 4 4 5 5 3 4 1 4 1 3 1 4 4 5 4 1 4 3 3 1 3 3 1 5 3 3 5 3 0 5 4 5 4 1 0 0 
0 0 0 0 0 0 0 0 0 3 4 3 4 1 4 1 1 1 1 4 3 1 1 0 3 5 3 1 1 3 4 3 3 4 6 4 3 4 1 3 4 1 3 3 1 4 1 3 0 0 
0 0 0 0 0 0 0 0 0 1 3 4 1 3 3 4 1 3 1 3 3 3 4 4 3 4 4 1 1 3 3 1 1 3 3 4 3 4 4 1 1 1 3 4 3 3 4 5 0 0 
0 0 0 0 0 0 0 0 0 0 5 3 1 3 1 3 4 3 4 1 1 1 4 1 1 1 3 4 3 4 4 1 3 1 3 3 4 3 4 3 4 4 5 3 4 4 3 3 1 0 
0 0 0 0 0 0 0 0 0 0 1 1 1 3 3 3 4 1 1 3 5 4 3 3 1 5 4 1 1 1 3 3 1 1 3 4 4 1 1 4 1 1 1 5 3 4 1 5 1 0 
0 0 0 0 0 0 0 0 0 0 0 3 1 1 1 3 3 3 1 1 4 3 1 4 3 4 1 5 5 1 1 3 4 5 3 4 1 3 4 1 1 3 1 4 1 3 3 3 4 1 
0 0 0 0 0 0 0 0 0 0 0 1 3 4 1 1 4 1 1 3 3 3 1 4 3 1 3 1 1 3 5 1 3 3 1 1 1 1 3 4 3 3 3 3 3 4 4 1 4 1 
0 0 0 0 0 0 0 0 0 0 0 3 0 1 3 1 4 1 4 4 1 3 1 1 3 6 4 3 4 1 3 1 4 3 3 1 1 5 1 3 3 3 3 1 4 4 1 3 4 3 
0 0 0 0 0 0 0 0 0 0 0 4 3 4 1 1 1 3 1 5 3 1 5 5 1 4 1 3 1 3 3 3 3 4 3 3 1 3 1 1 4 3 1 3 3 1 4 3 1 4 
0 0 0 0 0 0 0 0 0 0 0 0 1 3 3 1 1 3 1 3 3 4 5 3 1 3 1 6 4 1 4 3 3 3 1 5 1 1 1 4 3 3 1 1 3 3 0 1 3 3 
0 0 0 0 0 0 0 0 0 0 0 0 1 5 1 3 3 3 1 5 1 4 3 1 1 1 1 1 5 4 1 3 3 4 4 4 1 4 4 3 4 1 1 3 3 5 3 1 1 3 
0 0 0 0 0 0 0 0 0 0 0 0 0 3 1 4 5 4 1 3 1 1 5 1 3 5 3 4 1 5 3 4 3 4 5 5 3 1 1 1 1 1 3 3 3 1 3 4 3 5 
0 3 1 1 0 0 0 0 0 0 0 0 0 0 3 3 1 3 3 1 4 1 4 4 1 1 3 3 5 4 4 5 3 1 4 4 1 3 3 1 5 1 1 1 3 1 1 1 3 3 
5 3 3 3 1 4 3 4 0 0 0 0 0 0 0 0 3 1 4 3 4 3 1 1 1 5 1 3 1 4 5 1 3 3 3 3 0 4 1 3 3 1 1 1 3 3 3 3 1 5 
4 1 4 1 3 3 1 3 3 0 0 0 0 0 0 0 0 0 1 4 5 1 4 4 5 1 5 3 3 5 3 1 1 1 1 3 1 3 1 3 4 3 1 1 3 1 1 3 1 5 
1 5 1 1 5 3 3 1 3 0 0 0 0 0 0 0 0 0 0 0 3 3 1 1 4 3 4 1 1 5 1 0 1 3 4 4 1 1 3 4 4 1 1 1 3 4 1 3 1 5 
4 3 1 1 1 3 1 3 3 0 0 0 0 0 0 0 0 0 0 0 0 0 0 3 1 1 3 3 1 1 4 4 1 4 1 4 1 1 4 3 1 1 5 3 5 1 3 0 3 4 
3 1 5 3 3 1 3 4 5 0 0 0 0 0 0 0 0 0 0 0 0 0 0 0 0 1 3 4 1 3 1 3 1 0 3 1 3 3 4 3 3 4 4 3 3 1 3 4 4 3 
3 3 1 1 1 1 4 4 4 0 0 0 0 0 0 0 0 0 0 0 0 0 0 0 0 0 0 0 1 4 1 3 1 1 3 1 1 4 3 3 5 3 5 4 3 3 3 5 1 1 
4 1 3 1 4 1 5 1 1 0 0 0 0 0 0 0 0 0 0 0 0 0 0 0 0 0 0 0 0 0 3 4 3 1 1 5 1 3 3 1 3 1 3 4 1 1 1 1 5 4 
3 4 4 1 4 3 3 5 1 0 0 0 0 0 0 0 0 0 0 0 0 0 0 0 0 0 0 0 0 0 0 0 0 0 4 1 3 4 5 3 1 3 1 4 4 4 1 1 1 4 
3 3 1 3 4 3 3 6 5 0 0 0 0 0 0 0 0 0 0 0 0 0 0 0 0 0 0 0 0 0 0 0 0 0 0 0 0 3 3 3 1 4 4 3 1 1 4 5 1 1 
3 1 1 3 3 3 1 4 5 0 0 0 0 0 0 0 0 0 0 0 0 0 0 0 0 0 0 0 0 0 0 0 0 0 0 0 0 0 0 0 3 4 3 5 4 3 4 1 5 4 
4 3 1 3 3 4 1 1 4 0 0 0 0 0 0 0 0 0 0 0 0 0 0 0 0 0 0 0 0 0 0 0 0 0 0 0 0 0 0 0 0 0 0 1 4 4 1 1 3 3 
4 3 3 1 1 4 4 4 4 0 0 0 0 0 0 0 0 0 0 0 0 0 0 0 0 0 0 0 0 0 0 0 0 0 0 0 0 0 0 0 0 0 0 0 0 4 1 1 1 5 
1 3 1 6 1 1 3 1 1 0 0 0 0 0 0 0 0 0 0 0 0 0 0 0 0 0 0 0 0 0 0 0 0 0 0 0 0 0 0 0 0 0 0 0 0 0 0 3 1 5 
1 0 1 1 3 5 1 1 0 0 0 0 0 0 0 0 0 0 0 0 0 0 0 0 0 0 0 0 0 0 0 0 0 0 0 0 0 0 0 0 0 0 0 0 0 0 0 0 0 1 
1 5 5 1 3 1 1 5 0 0 0 0 0 0 0 0 0 0 0 0 0 0 0 0 0 0 0 0 0 0 0 0 0 0 0 0 0 0 0 0 0 0 0 0 0 0 0 0 0 0 
3 4 1 3 1 1 4 4 0 0 0 0 0 0 0 0 0 0 0 0 0 0 0 0 0 0 0 0 0 0 0 0 0 0 0 0 0 0 0 0 0 0 0 0 0 0 0 0 0 0 
1 5 3 1 1 4 3 4 0 0 0 0 0 0 0 0 0 0 0 0 0 0 0 0 0 0 0 0 0 0 0 0 0 0 0 0 0 0 0 0 0 0 0 0 0 0 0 0 0 0 
1 1 3 3 1 4 1 3 0 0 0 0 0 0 0 0 0 0 0 0 0 0 0 0 0 0 0 0 0 0 0 0 0 0 0 0 0 0 0 0 0 0 0 0 0 0 0 0 0 0 
5 4 4 3 3 1 1 3 0 0 0 0 0 0 0 0 0 0 0 0 0 0 0 0 0 0 0 0 0 0 0 0 0 0 0 0 0 0 0 0 0 0 0 0 0 0 0 0 0 0 
3 1 1 3 1 1 3 1 0 0 0 0 0 0 0 0 0 0 0 0 0 0 0 0 0 0 0 0 0 0 0 0 0 0 0 0 0 0 0 0 0 0 0 0 0 0 0 0 0 0 
4 4 4 5 1 4 5 3 0 0 0 0 0 0 0 0 0 0 0 0 0 0 0 0 0 0 0 0 0 0 0 0 0 0 0 0 0 0 0 0 0 0 0 0 0 0 0 0 0 0 
4 5 4 1 3 1 1 3 0 0 0 0 0 0 0 0 0 0 0 0 0 0 0 0 0 0 0 0 0 0 0 0 0 0 0 0 0 0 0 0 0 0 0 0 0 0 0 0 0 0 
3 1 6 3 3 3 1 1 0 0 0 0 0 0 0 0 0 0 0 0 0 0 0 0 0 0 0 0 0 0 0 0 0 0 0 0 0 0 0 0 0 0 0 0 0 0 0 0 0 0 
1 3 1 5 4 1 1 4 0 0 0 0 0 0 0 0 0 0 0 0 0 0 0 0 0 0 0 0 0 0 0 0 0 0 0 0 0 0 0 0 0 0 0 0 0 0 0 0 0 0 
1 3 4 3 3 1 3 1 0 0 0 0 0 0 0 0 0 0 0 0 0 0 0 0 0 0 0 0 0 0 0 0 0 0 0 0 0 0 0 0 0 0 0 0 0 0 0 0 0 0 
4 3 1 5 1 4 3 3 0 0 0 0 0 0 0 0 0 0 0 0 0 0 0 0 0 0 0 0 0 0 0 0 0 0 0 0 0 0 0 0 0 0 0 0 0 0 0 0 0 3 
4 3 5 3 3 3 4 1 0 0 0 0 0 0 0 0 0 0 0 0 0 0 0 0 0 0 0 0 0 0 0 0 0 0 0 0 0 0 0 0 0 0 0 0 0 0 0 0 1 3 
3 3 1 1 3 3 3 4 1 0 0 0 0 0 0 0 0 0 0 0 0 0 0 0 0 0 0 0 0 0 0 0 0 0 0 0 0 0 0 0 0 0 0 0 0 0 0 0 4 3 
3 4 3 4 3 3 3 3 1 0 0 0 0 0 0 0 0 0 0 0 0 0 0 0 0 0 0 0 0 0 0 0 0 0 0 0 0 0 0 0 0 0 0 0 0 0 0 3 3 3 
4 1 3 3 1 3 4 5 4 3 0 0 0 0 0 0 0 0 0 0 0 0 0 0 0 0 0 0 0 0 0 0 0 0 0 0 0 0 0 0 0 0 0 0 0 0 1 4 3 1 
1 3 4 0 3 1 3 5 5 5 0 0 0 0 0 0 0 0 0 0 0 0 0 0 0 0 0 0 0 0 0 0 0 0 0 0 0 0 0 0 0 0 0 0 0 4 1 3 4 5 
